80
1

                               ####  ####  ####
                               ####  ####  ####
                               ####  ####  ####
                               ####  ####  ####
                               ####  ####  ####
                               ####  ####  ####
                               ####  ####  ####
                               ###   ####   ###
                               ###   ####   ###
                              ####   ####   ####
                              ####   ####   ####
                             ####    ####    ####
                             ####    ####    ####
                            ####     ####     ####
                            ####     ####     ####
                           ####      ####      ####
                          #####      ####      #####
                        ######       ####       ######
                       ######        ####        ######
                      #####          ####          #####
                     ####            ####            ####
