100
1

                                    ######
                                 ############
                               ##############
                             #######        #
                            ######           ####### 
                           ######            #####
                           ######            ##
                           ######
                           ######            ##
                           ######            #####
                            ######           #######
                             ######         #
                               ##############
                                 ############
                                    ######
