111
1

        ####### #     #    #    #     # #    #     #     # ####### #     #
           #    #     #   # #   ##    # #   #       #   #  #     # #     #
           #    #     #  #   #  # #   # #  #         # #   #     # #     #
           #    ####### #     # #  #  # ###           #    #     # #     #
           #    #     # ####### #   # # #  #          #    #     # #     #
           #    #     # #     # #    ## #   #         #    #     # #     #
           #    #     # #     # #     # #    #        #    #######  #####
   
                        #    #     # ####### ######  #     #
                       # #   #     # #       #     #  #   #
                      #   #  #     # #       #     #   # #
                     #     # #     # #####   ######     #
                     #######  #   #  #       #   #      #
                     #     #   # #   #       #    #     #
                     #     #    #    ####### #     #    #
